3333333332-
0010001002-
1010101012-
1010101012-
1000100012-
3333333332


